to appreciate (sb./sth.) - ценить кого-л./что-л. [2] 
relatives - родственники, родные [1]
pale - бледный, тусклый [3]
noble - благородный, величественный [3]
to yawn - зевать [2]
glance - взгляд, быстрый взгляд [1]
veil - вуаль, завеса, фата [1]
to sob - рыдать, всхлипывать [2]
den - логово, притон, каморка [1]
absence - отсутствие, прогул [1]
to twitch - дёргаться, дёрнуться [2]
to exhaust (sb./sth.) - изнурять, истощать, выматывать кого-л./что-л. [2]
modest - скромный, ограниченный, небольшой [3]
purpose - цель, назначение, задача [1]
to accompany (sb./sth.) - сопровождать, сопутствовать кому-л./чему-л. [2]
within - в пределах, внутри [6]
indeed - действительно, в самом деле, конечно [4]
cheerful - весёлый, жизнерадостный [3]
disgust - отвращение, брезгливость, омерзение [1]
steep - крутой, резкий, отвесный [3]
gap - зазор, разрыв, пробел [1]
hollow - полый, пустой, впалый [3]
thick - тостый, густой, плотный [3]
to bow (sth.) - кланяться, склонять что-л. [2]
to bend (sb./sth.) - гнуть, покоряться, покорять кого-л. [2]
chin - подбородок [1]
beside - рядом, около, возле [6]
brazier - жаровня, мангал [1]
fist - кулак [1]
unkempt - неопрятный, неряшливый [3]
to sink (sth.) - тонуть, погружаться, потопить что-л. [2]
to owe sb. - задолжать, быть обязанным кому-л. [2]
passage - переход, проход, прохождение, отрывок, принятие [1]
narrow - узкий, тесный, ограниченный [3]
stupefying - дурманящий [5]
fume - дым, испарение, пар [1]
light-house - маяк [1]
crooked - изогнутый, кривой, извилистый [5]
to astonish sb. - удивлять, поражать кого-л. [2]
dull - тусклый, скучный, глупый, занудный [3]
to approach sb./sth. - подходить, приближаться к кому-л./чему-л. [2]
to refuse sth. (~ sb. ~) - отказывать кому-л. в чем-л., отвергать что-л. [2]
request - запрос, обращение, требование [1]
definitive - окончательный, исчерпывающий, отличительный [3]
imperative - повелительный, настоятельный [3]
however - однако, тем не менее [6]
certain - определённый, конкретный, соответствующий [3]
to straighten sth. - выпрямить, выровнять, расправить что-л. [2]
burst - взрыв, всплеск [1]
prey - добыча, жертва [1]
inquiry - запрос, расследование, наведение справок [1]
whistle - свист, свисток [1]
to conduct (sth.) - проводить, осуществлять, руководить чем-л. [2]
chain - сеть, цепь, вереница [1]
beneath - внизу, под, низко [6]
sorely - очень, тяжко, мучительно [4]
to interrupt (sb./sth.) - прерывать, приостанавливать, перебивать кого-л./что-л. [2]
suburban - пригородный, загородный [3]
somehow - как-то, почему-то, так или иначе [4]
brief - краткий, короткий, сжатый, лаконичный [3]
amount - сумма, количество, объём [1]
to receive (sb./sth.) - получать, принимать кого-л./что-л. [2]
parcel - посылка, пакет, участок [1]
considerable - значительный, существенный [3]
anxious - тревожный, встревоженный, беспокойный [3]
frantically - судорожно, неистово, отчаянно [4]
to wave - махать, размахивать [2]
irresistable - неотразимый, непреодолимый [3]
necktie - галстук [1]
to convince sb. - убеждать кого-л. [2]
cripple - калека, инвалид [1]
to tear (sth.) - рвать, рваться, отрывать что-л. [2]
lid - крышка, веко [1]
evident - очевидный, явный, наглядный [3]
plain - простой, обычный, ясный, очевидный [3]
boot - ботинок, сапог, бутса [1]
stain - пятно, краска [1]
sill - подоконник, порог [1]
villain - злодей, преступник, негодяй [1]
accessory - аксессуар, принадлежность, приспособление, соучастник [1]
to deny (sth.) - отрицать, отказывать, отвергать что-л. [2]
lodger - жилец, постоялец [1]
beggar - нищий, бедняк, попрошайка [1]
to pretend - притворяться, делать вид, представлять [2]
tiny - маленький, крошечный, небольшой [3]
stock - запас, склад [1]
to pave sth. - прокладывать, мостить, покрывать что-л. [2]
pavement - тротуар, дорожное покрытие, мостовая [1]
charity - благотворительность, милосердие [1]
leather - кожа, кожаные изделия [1]
acquaintance - знакомство, знакомый, приятель [1]
scar - шрам, рубец [1]
outer - внешний, наружный, крайний [3]
edge - край, грань, окраина [1]
common - общий, обычный, единый, простой, общепринятый [3]
feather  - перо, пёрышко [1]
to sparkle - сверкать, блестеть, сиять [2]
to faint - падать в обморок, терять сознание [2]
sense - смысл, чувство, ощущение, разум [1]
sight - взгляд, вид, поле зрения [1]
fault  - вина, неисправность, дефект, неполадка, брак, недочёт [1]
to remedy (sth.) - устранять, исправлять, возмещать что-л. [2]
suspicious - подозрительный, недоверчивый [3]
claim - заявление, иск, претензия [1]
to claim (sth.) - утверждать, претендовать на что-л [2]
to remain - оставаться [2]
pocket - карман, скопление, отделение [1]
to sweep sth. - мести, вычищать, чистить что-л. [2]
victim - жертва, пострадавший [1]
innocent - невинный, невиновный [3]
to suspect sb./sth. - подозревать кого-л./что-л. [2]
witness - свидетель, очевидец [1]
outskirts - окраина, предместья [1]
counties - округа, графства, уезды [1]
besides - кроме, кроме того, помимо [6]
either - также, тоже, либо, любой (из двух) [6]
frankly - откровенно, честно, прямо [4]
envelope - конверт, оболочка [1]
ink - чернила, тушь, краска [1]
seal - уплотнение, печать, знак, уплотнитель [1]
to seal sth. - запечатывать что-л. [2]
to chew sth. - жевать, пережёвывать что-л. [2] 
unless - если не, только если, если только [6]
forgery - подлог, подделка, фальшивка [1]
to discourage sb. - отговаривать, обескураживать кого-л. [2]
to thrust sb./sth. - засовывать кого-л./что-л. [2]
cosy - уютный, удобный [3]
to disturb (sb./sth.) - беспокоить, мешать кому-л. [2]
inn - трактир, гостиница [1]
convict - преступник, осуждённый, заключённый [1]
to accuse sb. - видвигать обвинения против, упрекать кого-л. [2]
to supply (sth.) - поставлять, снабжать чем-л. [2]
to distinguish (sb./sth.) - различать, отличать, распознавать кого-л./что-л. [2]
obvious - очевидный, явный, наглядный [3]
to tie sth. - завязывать, связывать [2]
at all - совсем, совершенно [4]
forceps - пинцет, щипцы, клещи [1]
lens - линзы, объектив, лупа [1]
shabby - поношенный, потёртый [3]
to shatter (sth.) - раздробить, разбиться вдребезги, разрушить что-л. [2]
to chuckle - усмехаться, хихикать [2]
cupboard - шкаф, шкафчик, буфет [1]
threat - угроза, опасность [1]
to fulfil sth. - выполнять, исполнять, осуществлять, соответствовать чему-л. [2]
suitcase - чемодан [1]
agility - ловкость, быстрота, проворство [1]
at once - сразу, тотчас [4]
accidental - случайный, непредвиденный, непреднамеренный [1]
will - желание, воля, завещание [1]
to argue (sth.) - утверждать, рассуждать, возражать, доказывать что-л. [2]
to disturb (sb./sth.) - беспокоить, мешать, тревожить кого-л. [2]
estate - недвижимость, усадьба, поместье, имущество [1]
draughts - шашки [1]
speckled - пятнистый, пёстрый, в крапинку, испещрённый [5]
objection - возражение, протест, несогласие [1]
due to - благодаря, из-за, по причине, в связи с [6]
to fetch (sth.) - приносить, извлекать что-л. [2]
cunning - хитрость, коварство [2]
sole - подошва [1]
joy - радость, веселье, восторг [1]
to kneel - преклонить колени, встать на колени [2]
damp - влажный, сырой, мокрый [3]
triffle - мелочь, пустяк, безделица [1]
inarticulate - неразборчивый, невнятный [3] 
to confess (sth.) - исповедоваться, признаваться, сознаться в чем-л. [2]
waistcoat - жилет, безрукавка [1]
pillow (cushion) - подушка [1]
to brag - хвастаться, хвалиться, кичиться [2]
mug - кружка, чашка [1]
enormous - огромный, колоссальный, небывалый, невероятный, громадный [3]
delight - удовольствие, восторг, радость [1]
temper - темперамент, нрав, характер [1]
to hiss - свистеть, шипеть [2]
saucer - блюдце, подставка, тарелка [1]
rope - верёвка, канат, трос [1]
income - доход, доходы, прибыль [1]
howling - вой, завывание [1]
lawn - газон, лужайка, батист [1]
to dare - отваживаться, сметь, дерзать [2]
to mop sth. - мыть, драить, убирать что-л. [2]
mop - швабра, копна, шевелюра [1]
indifferent - безучастный, безразличный, незаинтересованный, инертный [3]
ceiling - потолок, предельный уровень [1]
feature - функция, особенность, характерная черта [1]
statement - высказывание, отчёт, заявление, утверждение [1]
vain - пустой, тщеславный, напрасный [3]
to insist - настаивать, утверждать [2]
injury - травма, вред, повреждение [1]
to shave (sth.) - бриться, брить, сбривать что-л. [2]
sleeve - рукав, втулка [1]
gloomy - мрачный, угрюмый, хмурый [3]
to carry (sb./sth.) - нести, возить, таскать что-л. [2]
sharply - резко, решительно [4]
coarsely - грубо, приблизительно [4]
to protrude - выходить, выступать наружу [2]
tattered - изорванный, оборванный, драный [5]
forehead - лоб [1]
jug - кувшин [1]
bark - кора, лай [1]
to obey sb. - повиноваться, подчиняться, слушаться кого-л. [2]
destiny - судьба, участь, предназначение [1]
to resemble sb./sth. - походить, напоминать кого-л./что-л. [2]
cellar - погреб, подвал [1]
slit - прорезь, щель, разрез, паз [1]
to amuse sb. - развлекать, забавлять кого-л. [2]
faithful - верный, преданный [3]
shade - оттенок, тень [1]
tint - оттенок, тон [1]
chestnut - каштан, каштановый цвет [1]
cockroach - таракан [1]
right away - сразу [4]
carpenter - плотник, столяр [1]
to deserve sb./sth. - заслуживать кого-л./что-л. [2]
moustache - усы [1]
interrogation - допрос, дознание [1]
facial - лицевой, предназначенный для лица [3]
admiration - восхищение, восторг [1]
fondness - пристрастие, любовь [1]
handcuffs - наручники [1]
coolness - хладнокровие, невозмутимость [1]
collar - воротник, ошейник [1]
handling - обработка, обращение, управление [1]
to preserve (sb./sth.) - оберегать, сохранять, консервировать что-л. [2]
precaution - мера предосторожности, предосторожность [1]
purse - кошелёк, сумка, денежный фонд [1]
to pat sb./sth. - похлопывать, шлёпать кого-л./что-л. [2]
despair - отчаяние, безысходность, уныние [1]
grief - горе, скорбь, печаль [1]
jerk - рывок, толчок [1]
broad - широкий, обширный, полный [3]
gash - рана, надрез, прорезь [1]
spark - искра, огонёк, проблеск [1]
glint - блеск, вспышка [1]
stern - суровый, жёсткий, кормовой, задний [3]
lantern - фонарь, лампа, светильник [1]
to baffle sb. - препятствовать, мешать кому-либо, сбивать с толку [2]
magnificent - великолепный, прекрасный, восхитительный [3]
hedge - изгородь, ограда [1]
rage - ярость, гнев [1]
treasure - сокровище, клад, драгоценность [1]
branch - филиал, отделение, отрасль, ветвь [1]
bold - смелый, дерзкий, отважный, полужирный (шрифт) [3]
weariness - усталость, утомление [1]
affection - любовь, привязанность, симпатия [1]
wistful - задумчивый, тоскливый, меланхоличный [3]
digestion - пищеварение, переваривание, усвоение [1]
beyond - за, за пределами, вне, сверх [6]
intruder - злоумышленник, нарушитель [1]
to pursue - преследовать, продолжать, гнаться за кем-либо [2]
belly - живот, брюхо [1]
flesh - плоть, мясо, мякоть [1]
to hint - намекать, давать понять [2]
to arise - возникать, появляться, подниматься [2]
to cease (sth.) - прекращать, приостанавливать, переставать [2]
leap - скачок, прыжок, прорыв [1]
chase - погоня, преследование, охота [1]
to snarl - рычать, огрызаться [2]
rifle - винтовка, карабин, ружьё [1]
meantime - тем временем, между тем [4]
grip - захват, сцепление, контроль, хватка [1]
conscious - осознанный, сознательный [3]
unbearable - нестерпимый, невыносимый [3]
mitten - варежка, рукавица [1]
thus - таким образом [4]
arrogance - высокомерие, надменность, заносчивость [1]
vain - пустой, тщеславный, напрасный [3]
anticipation - ожидание, предвидение, предвкушение [1]
deliberate - преднамеренный, умышленный, обдуманный, взвешенный [3]
brute - зверь, животное [1]
to starve (sb.) - голодать, морить кого-либо [2]
lean - тощий, худой, постный [3]
corresponding - соответствующий, подобный [3]
advance - прогресс, наступление, продвижение, аванс [1]
menacing - зловещий, угрожающий, опасный [3]
dubious - сомнительный, неопределённый, двусмысленный [3]
nostril - ноздря [1]
wound - рана, ранение, обида [1]
remnant - остаток, пережиток [1]
plenty - множество, обилие, избыток [1]
fierce - свирепый, ожесточённый, жестокий [3]
savage - дикарь, варвар, грубиян [1]
abreast - в ряд, на одной линии [4]
harness - сбруя, упряжь [1]
obstacle - преграда, препятствие, помеха [1]
breed - порода, род, племя, сорт [1]
caressing - ласковый [3]
cub - детёныш [1]
squeal - визг, скрип, вопль [1]
entire - весь, целый, полный [3]
lynx - рысь [1]
porcupine - дикобраз [1]
nevertheless - всё-таки, всё же [4]
jealous - ревнивый, завидующий [3]
to persuade sb. - склонять, убеждать, уговаривать [2]
sigh - вздох [1]
to embrace (sb./sth.) - обниматься, обнимать, обхватывать [2]
midst - середина, средь, посреди [6]
curiosity - любопытство, любознательность [1]
slope - склон, спуск, наклон, скат [1]
hostile - враждебный, недружелюбный [3]
obedience - послушание, повиновение, покорность [1]
therefore - поэтому, таким образом, так что [3]
remuneration - вознаграждение, оплата, гонорар [1]
mere - простой, чистый [3]
to bury (sb.) - закапывать, хоронить (кого-л.), зарывать [2]
claw - коготь, клешня [1]
revenge - реванш, месть, отмщение [1]
rapid - бурный, быстрый, стремительный, оперативный [3]
legacy - достояние, наследие, наследство [1]
to forbid sth. - запрещать, не позволять [2]
painstaking - кропотливый, тщательный, скрупулёзный [3]
lair - логово, берлога [1]
barely - едва, мало, лишь [4]
populous - густонаселённый, многолюдный [3]
to lurk - таиться, скрываться [2]
soothing - успокаивающий, смягчающий [3]
somewhat - немного, в некоторой степени [4]
apparently - очевидно, видимо, по-видимому [4]
tribe - племя. род, клан [1]
beaver - бобр, бобёр [1]
to wilt - вянуть, поникнуть, завять [2]
endurance - выносливость, прочность, стойкость [1]
invariably - неизменно, постоянно [4]
vengeance - возмездие, месть, мщение [1]
outcast - изгнанник, изгой [1]
to wail - вопить, причитать, выть, стенать [2]
to sorrow - скорбеть, горевать, печалиться [2]
sacred - святой, священный, сакральный [3]
sore - болячка, рана, ранка [1]
bruise - синяк, гематома, кровоподтёк [1]
likewise - также, аналогично, подобно [4]
to stumble - спотыкаться, оступаться, ошибаться [2]
to utter sth. - произносить, проговаривать что-л. [2]
mournful - грустный, жалостливый, горестный [3]
to afflict (sb.) - огорчать кого-л., беспокоить, тревожить [2]
dense - густой, плотный, непрозрачный [3]
wrath - гнев, ярость [1]
outlet - выход, розетка, отвод, торговая точка [1]
to detain (sb./sth.) - задерживать, удерживать кого-л./что-л. [2]
morose - угрюмый, замкнутый, мрачный [3]
to enforce sth. - обеспечивать исполнение, приводить что-либо в исполнение [2]
invincible - непобедимый, несокрушимый [3]
to surrender (sth.) - сдаваться, сдавать что-л., капитулировать [2]
to descend (to sb./sth.) - спускаться, сходить, снизойти до чего-либо [2]
to bare sth. - оголять, обнажать что-л. [2]
to bristle - топорщиться [2]
concrete - бетон, цемент [1]
ancestor - предок, родоначальник, предшественник [1]
primacy - примат, первенство, верховенство [1]
to tame sb. - укрощать, усмирять, приручать кого-л. [2]
dim - тусклый, мутный, приглушённый [3]
to postpone sth. - откладывать, переносить что-л. на более поздний срок [2]
fierce - свирепый, ожесточённый, жестокий [3]
to swallow (sth.) - глотать, сдерживать, подавлять что-л. [2]
to groan - стонать, охать [2]
to grunt - хрюкать, ворчать [2]
oblong - продолговатый, вытянутый, прямоугольный [3]
sled - сани, санки, упряжка [1]
eternity - вечность, бесконечность [1]
merit - заслуга, достоинство, доблесть [1]
to endure (sth.) - выдержать, вытерпеть, пройти через что-либо [2]
solitary - одиночка, отшельник [1]
jealousy - ревность, зависть [1]
taut - натянутый, подтянутый, упругий [3]
whip - плеть, кнут хлыст [1]
strap - ремень, ремешок, лента [1]
covenant - завет, пакт, соглашение [1]
participant - участник [1]
shambles - руины, разруха, развалины [1]
to resent (sb./sth.) - возмущаться, негодовать, обижаться на кого-л./что-л. [2]
joyous - радостный, весёлый, довольный [3]
vaguely - смутно, туманно, неточно [4]
regard - внимание, почтение, забота [1]
faith - вера, вероисповедание, убеждение, доверие [1]
dignity - достоинство, сан, гордость [1]
collocation - словосочетание, расстановка, расположение [1]
malice - злоба, злость [1]
scrawny - костлявый, тощий [3]
thoroughly - тщательно, основательно, досконально [4]
splendid - великолепный, прекрасный, роскошный [3]
to mould (sb./sth.) - отливать, формировать, лепить кого-л./что-л. [2]
bitter - горький, суровый, жестокий [3]
scatter - разброс, разбег [1]
to offend (sb.) - оскорбить, обидеть (кого-л.) [2]
offender - преступник, нарушитель, обидчик [1]
stroke - ход, удар, инсульт, штрих, такт [1]
clumsy - неуклюжий, неповоротливый [3]
steamer  - пароход, отпариватель, пароварка [1]
manifestation - проявление, выражение, манифестация [1]
to exceed (sb./sth.) - превышать, превосходить что-л. [2]
profit - доход, прибыль, выгода, польза [1]
praise - похвала, хвала, восхваление [1]
loose - свободный, рыхлый, распущенный, просторный [3]
former - бывший, прежний, предыдущий, прошлый [3]
torment - мука, мучение, терзание [1]
to tease (sb./sth.) - дразнить, разжигать интерес, подначивать кого-л. [2]
to reign - царствовать, править, преобладать [2]
to cling - цепляться, льнуть, облегать, держать, прилипать [2]
deck - палуба, площадка [1]
to sever sth. - разорвать, оборвать, порвать, отрезать что-л. [2]
to estimate (sth.) - оценивать, прикидывать что-л. [2]
sober - трезвый, сдержанный, рассудительный, здравомыслящий [3]
fidelity - верность, точность, преданность, чёткость [1]
to redeem sth. - выкупать, искуплять что-л. [2]
shivering - дрожь, озноб, дрожание [1]
treachery - предательство, подлость, вероломство [1]
loose - свободный, рыхлый, распущенный, просторный, распутный, развязанный [3]
reluctant - вынужденный, неохотный, нерасположенный [3]
indomitable - неукротимый, несгибаемый, упрямый [3]
to loosen sth. - рыхлить, ослаблять что-л. [2]
muzzle - морда, намордник, дуло [1]
apprehension - опасение, понимание, задержание, восприятие, арест [1]
to glare - сверлить взглядом, сверкать, пялиться [2]
decisive - решительный, окончательный, решающий, убедительный [3]
to snuggle - прижиматься, уютно устраиваться, прислоняться [2]
to suffocate - захлёбываться, задыхаться [2]
revolt - восстание, бунт, мятеж [2]
bedding - постельное бельё [1]
irritable - раздражительный [3]
to vanish - исчезать, пропадать, стремиться к нулю [2]
to expose (sb./sth.) - раскрывать, выявлять, выставлять, обнажать кого-л./что-л. [2]
squat - корточки, приседание [1]
haste - поспешность, спешка, торопливость [1]
marvellous - чудесный, замечательный, изумительный [3]
to grasp (sth.) - понять, улавливать, постигать, схватывать что-л. [2]
to duck (sth.) - нырять, уворачиваться, наклонять что-л. [2]
to dodge (sth.) - уклоняться, изворачиваться, избегать (чего-л.) [2]
prosperous - процветающий, благополучный, зажиточный [3]
to irritate (sb./sth.) - раздражать, сердить, злить кого-л. [2]
slight - лёгкий, небольшой, незначительный, хрупкий [3]
allegiance - верность, преданность, приверженность [1]
inevitable - неизбежный, неотвратимый, неминуемый [3]
malignant - злокачественный, злобный, вредоносный [3]
harsh - суровый, резкий, жёсткий, грубый, шероховатый [3]
sane - разумный, вменяемый, здравый [3]
indignation - возмущение, негодование [3]
violation - нарушение, надругательство, насилие [1]
furthermore - кроме того, также, к тому же [4]
to distort (sth.) - искажать, искривлять, деформировать, извращать что-л. [2]
coward - трус, трусиха [1]
muddy - илистый, грязный, мутный [3]
powder - порошок, пудра, порох [1]
disdain - презрение, пренебрежение [1]
prolonged - длительный, продолжительный, продлённый [5]
marvel - чудо, диво [1]
to declare (sth.) - заявлять, объявить что-л. [2]
refuge - убежище, прибежище, приют, пристанище [1]
snare - ловушка, западня, капкан [1]
vaguely - смутно, туманно, неточно, неясно [4]
regard - внимание, почтение, забота [1]
custom - обычай, традиция, привычка [1]
namely - а именно, то есть, конкретно [4]
survey - опрос, обследование, исследование, обзор, осмотр [1]
preference - предпочтение, преимущество, льгота [1]
to acknowledge sth. - подтверждать, сознавать что-л. [2]
starvation - голодание, голод, истощение [1]
pasture - выгон, пастбище [1]
to dismount (sth.) - снимать, разбирать, демонтировать, спешиваться [2]
wholehearted - искренний, беззаветный [3]
quizzical - шутливый, насмешливый, вопросительный [3]
elusive - неуловимый, ускользающий, труднодостижимый, иллюзорный [3]
drowsiness - сонливость, вялость [1]
to loathe (sb./sth.) - ненавидеть, презирать, отрицательно относиться к кому-л./чему-л. [2]
sufficient - достаточный, надлежащий, обоснованный [3]
to adjust (sth.) - регулировать, корректировать, настраивать что-л. [2]
to admit (sb./sth.) - признавать, допускать, принимать кого-л./что-л. [2]
chamber - палата, камера, комната [1]
swift - быстрый, стремительный, скорый [3]
to pace - шагать, расхаживать, идти шагом [2]
to employ (sb./sth.) - использовать, нанимать, трудоустраивать кого-л. [2]
to woo sb. - свататься, ухаживать, добиваться расположения кого-л. [2]
to summon (sb./sth.) - вызывать, призывать, созывать кого-л./что-л. [2]
rescue - спасение, освобождение [1]
precise - точный, конкретный, чёткий, аккуратный, щепетильный [3]
peculiar - своеобразный, особый, необычный, особенный [3]
to endeavour - стремиться, пытаться, прилагать усилия [2]
presumably - предположительно, вероятно, возможно [4]
insensibly - незаметно, неощутимо [4]
incisive - острый, язвительный, колкий, проницательный [3]
languid - вялый, томный, апатичный [3]
to implicate sb. - вовлекать, впутывать, делать кого-либо причастным [2]
to quench sth. - утолять, гасить, заливать, тушить что-л. [2]
shelter - приют, убежище, укрытие, навес [1]
rumble - гул, грохот, шум [1]
discretion - благоразумие, усмотрение, осмотрительность [1]
ado - суматоха, суета [1]
rampage - буйство, ярость, неистовство, бешенство [1]
sneeze - чиханье, чих [1]
obstinacy - упорство, упрямство [1]
curb - бордюр, бортик, обочина [1]
to curb sb./sth. - сдерживать кого-л./что-л. [2]
hoof - копыто [1]
trifling - незначительный, пустячный, плёвый [3]
riot - бунт, беспорядки, буйство, волнение [1]
figment - вымысел, фикция [1]
remorse - раскаяние, сожаление, угрызения совести [1]
to holler - кричать, вопить [2]
to confide sth. to (sb./sth.) - доверять, поручать, вверять что-л. кому-л./чему-л. [2]
to conceal (sb./sth.) - скрывать, таить, маскировать что-л. [2]
to hurl sth. - метать, бросать, швырять что-л. [2]
to condescend - снисходить, унижаться [2]
chamois - замша, серна [1]
betrothal - обручение, помолвка [1]
resolute - решительный, непоколебимый, твёрдый [3]
reproach - укор, упрёк, осуждение [1]
errand - поручение, задание [1]
to waylay sb. - подстерегать кого-л., устраивать засаду [2]
to ransack - грабить, обыскивать, искать [2]
indiscretion - неосмотрительность, неосторожность [1]
to entangle (sb./sth.) - путать, запутывать кого-л./что-л. [2]
docket - выписка, этикетка, перечень [1]
to docket (sth.) - вести книгу записей, маркировать, вносить что-л. в перечень [2]
garbage - мусор, отбросы [1]
recon - разведка, проводить разведку [1]
to adopt (sb./sth.) - принимать, усыновлять, перенимать что-л. [2]
imperfection - несовершенство, дефект, недостаток [1]
to refrain - воздерживаться, удерживаться [2]
vile - гнусный, мерзкий, подлый [3]
hence - следовательно, поэтому, таким образом [4]
to scrape sth. - царапать, скрести, чистить что-л. [2]
extortion - вымогательство, побор, шантаж [1]
to kidnap sb. - похищать кого-л. [2]
to depict sth. - обрисовывать, отображать что-л. [2]
incorrigible - неисправимый [3]
trifle - мелочь, пустяк, малость, безделушка [1]
wedlock - брак, супружество, законный брак [1]
vague - смутный, туманный, расплывчатый, неясный [3]
compelled - вынужденный, принуждаемый, подчинённый [5]
preposterous - нелепый, абсурдный [3]
to emerge - возникать, появляться, выясняться [2]
to disguise sth. - маскировать, скрывать что-л. [2]
guise - наружность, облик, обличье, вид [1]
inextricable - неразрывный, неразрешимый, запутанный [3]
reckoning - счёт, расплата [1]
feast - праздник, пир, торжество [1]
sinister - зловещий, злой, тёмный [3]
decay - распад, упадок, разложение, гниение [1]
ominous - зловещий, жуткий, угрожающий [3]
idler - бездельник, лентяй [1]
dashing - сильный, энергичный, лихой [3]
dainty - изысканный, изящный, утончённый, лакомый [3]
to assess sth. - оценивать, рассматривать что-л. [2]
to necessitate - требовать, вынуждать, делать необходимым [2]
to beam (sb./sth.) - сиять, излучать, широко улыбаться, испускать что-л. [2]
to vouch sb./sth. - поручиться за кого-л./что-л. [2]
deceit - обман, лживость, хитрость, уловка [1]
appetiser - закуска, аперитив [1]
sewer - канализация, коллектор, швея [1]
burden - бремя, нагрузка, груз [1]
foe - враг, противник, неприятель [1]
brink - грань, край, берег, граница [1]
to forsake (sb./sth.) - покинуть, оставить, отказаться от, бросать, отрекаться от кого-л./чего-л. [2]
peril - опасность, риск, угроза [1]
to mend sth. - чинить, штопать, исправлять что-л. [2]
trinket - брелок, безделушка, мелочь [1]
void - пустота, вакуум, полость, пробел [1]
detour - объезд, обход [1]
gaze - взгляд, взор [1]
to discern (sb./sth.) - разглядеть, различать кого-л./что-л. [2]
meadow - луг, поляна [1]
pillage - грабёж, мародёрство, разграбление [1]
horde - орда, толпа, полчище [1]
to repel (sb./sth.) - отбивать, отражать, отталкивать кого-л./что-л. [2]
to foresee sth. - предвидеть, предугадать, предусматривать что-л. [2]
to unleash (sb./sth.) - высвободить, развязывать, выпускать кого-л./что-л. [2]
to dwell - обитать, жить, пребывать, останавливаться [2]
fading - увядание, угасание, затухание [1]
breach - нарушение, невыполнение, брешь, пролом, разрыв [1]
to falter - дрогнуть, замедляться, спотыкаться, запинаться [2]
to wane - убывать, иссякать, ослабевать, угасать [2]
to forfeit sth. - потерять право на, лишаться, утрачивать что-л. [2]
oath - клятва, присяга, обет [1]
wicked - злой, нечестивый, коварный, подлый [3]
vulnerable - ранимый, уязвимый, чувствительный [3]
massacre - резня, бойня, массовое убийство [1]
to linger (sth.) - задерживаться, оттягивать, мешкать, бездельничать [2]
to perish (sth.) - погибать, исчезать, портиться [2]
courtesy - вежливость, учтивость, любезность [1]
woe - горе, скорбь, беда, несчастье [1]
herald - вестник, глашатай, предвестник [1]
tide - прилив, течение, поток [1]
to plunge (sb./sth.) - погружаться, окунать кого-л./что-л. [2]
mercenary - наёмник [1]
incredible - невероятный, потрясающий, неимоверный, бесподобный, невообразимый [3]
awesome - удивительный, отличный, великолепный [3]
heathen - язычник, дикарь, варвар, безбожник [1]
pledge - залог, обещание, обязательство [1]
to seek (sb./sth.) - искать, стремиться, добиваться, просить, обращаться за чем-л. [2]
eve - канун, преддверие [1]
to hasten (sb./sth.) - спешить, торопиться, ускорять что-л. [2]
tread - ступень, проступь, походка [1]
wretch - негодник, мерзавец, подлец [1]
henceforth - отныне, впредь, в дальнейшем [4]
collation - сопоставление, сверка, сравнение, проверка [1]
to shrink - уменьшаться, сморщиться, усыхать [2]
to weep - плакать, рыдать, запотевать [2]
comprehension - осмысление, понимание, восприятие, постижение [1]
to anticipate (sth.) - предвидеть, ожидать, предвкушать что-л. [2]
fugitive - беглец, эмигрант, беженец [1]
deed - дело, документ, поступок [1]
testimony - свидетельство, показание, доказательство [1]
epitome - краткое изложение, воплощение, конспект [1]
apron - фартук, передник, авансцена [1]
to assemble (sb./sth.) - собирать, монтировать, сооружать, созывать кого-л./что-л. [2]
to supplant sb./sth. - вытеснять кого-л./что-л. [2]
subtle - тонкий, изысканный, ловкий [3]
inquisitive - любознательный, пытливый, любопытный [3]
to convey sth. - передавать, выражать, транспортировать что-л. [2]
to interfere - препятствовать, вредить [2]
glimpse - проблеск, мелькание, быстрый взгляд [1]
filth - грязь, скверна, мерзость, запущенность [1]
aisle - неф, проход, коридор, отсек, придел [1]
to rot - гнить, портиться, разлагаться [2]
slaughter - убой, забой, бойня, резня, убийство [1]
captive - пленник, пленный [1]
to stink - вонять, смердеть, быть отвратительным [2]
acute - резкий, острый, сильный, точный, проницательный [3]
benevolent - благожелательный, доброжелательный, великодушный [3]
amiable - дружелюбный, любезный, приятный [3]
formidable - грозный, внушительный, труднопреодолимый [3]
ally - союзник, соратник [1]
ambush - засада, западня, укрытие [1]
peasant - крестьянин, простолюдин [1]
to aspire to sth. - стремиться, стараться, претендовать на что-л. [2]
spear - копьё, острога, дротик [1]
quarry - каменоломня, карьер, добыча [1]
nasty - мерзкий, противный, неприятный [3]
bog, marsh, swamp - болото, болотистая местность, топь, трясина [1]
to warrant (sth.) - гарантировать, оправдывать что-л. [2]
to dampen sth. - гасить, мочить, приглушать, смягчить что-л. [2]
to diminish sth. - уменьшать, снижать что-л. [2]
lament - плач, причастие, сожаление [1]
to skew sth. - искажать что-л. [2]
wisp - пучок, обрывок, клочок [1]
foul - нечистый, гадкий, грязный [3]
inane - бессмысленный, глупый, бессодержательный [3]
succinct - ёмкий, краткий, сжатый [3]
gratitude - благодарность, признательность [1]
stirring - перемешивание, взбалтывание, размешивание [1]
riddle - загадка, тайна, ребус [1]
odd - нечётный, странный, необычный [3]
scuffle - драка, потасовка, стычка [1]
rattle - трещотка, погремушка, грохот [1]
gleam - отблеск, блеск [1]
capable - способный, умелый [3]
to relieve (sb./sth.) - освобождать, облегчать, уменьшать что-л. [2]
farewell - прощание [1]
bid - предложение, заявка, ставка [1]
proceeding - процедура, процесс, разбирательство [1]
solemn - торжественный, священный [3]
awkward - неловкий, неудобный, неуклюжий [3]
pagan - язычник, нехристь [3]
shrine - святилище, храм, святыня [1]
worship - поклонение, богослужение, почитание [1]
to fathom sth. - понимать, постигать, осознавать что-л. [2]
accomplice - сообщник, соучастник, подсобник [1]
uproar - шум, беспорядки, волнение [1]
to rejoice - радоваться, ликовать, торжествовать [2]
to assure (sb./sth.) - убеждать, гарантировать, заверять кого-л. [2]
cellular - клеточный, сотовый, сетчатый [3]
to curl (sth.) - виться, завивать что-л. [2]
mercy - милость, милосердие, сострадание [1]
to confound (sb./sth.) - разрушить что-л., сбить с толку, приводить кого-л. в замешательство [2]
genuine - истинный, искренний, подлинный, настоящий [3]
nudge - толчок, подталкивание [1]
scarce - дефицитный, редкий, недостаточный [3]
to perceive (sb./sth.) - воспринимать, чувствовать, ощущать что-л. [2]
rumour - слух, молва, толки [1]
to ensnare - заманивать, поймать в ловушку [2]
fabulous - сказочный, потрясающий, легендарный [3]
to ditch (sb./sth.) - выбросить, избавиться от кого-л./чего-л. [2]
grudge - обида, злоба, неприязнь [1]
recess - тайник, углубление, перерыв, ниша [1]
entourage - антураж, окружение, свита [1]
demand - спрос, потребность, требование [1]
to gain sth. - получать, добиваться, завоёвывать что-л. [2]
to regain sth. - возвращать, восстанавливать sth. [2]
precipitance - стремительность, поспешность, опрометчивость [1]
grim - мрачный, суровый, печальный [3]
relapse - рецидив, обострение, повторение [1]
consistent - последовательный, стабильный, устойчивый [3]
to devour (sb./sth.) - поглощать, пожирать кого-л./что-л. [2]
celestial - небесный [3]
tough - прочный, трудный, сложный, жёсткий, выносливый [3]
to evaluate sb./sth. - оценивать, давать оценку, составлять мнение о ком-л./о чем-л. [2]
to hail (sb./sth.) - приветствовать, провозглашать кого-л./что-л. [2]
slumber - дрёма, сон, дремота [1]
sincere - искренний, откровенный [3]
to resign - отказываться, уходить в отставку, слагать полномочия [2]
appointment - должность, назначение, приём, встреча [1]
to abandon sb./sth. - отказываться от, оставлять, покидать, бросать кого-л./что-л. [2]
emerald - изумруд [1]
hindrance - помеха, препятствие, преграда [1]
imprudent - неосторожный, неосмотрительный [3]
shutter - жалюзи, затвор, заслонка [1]
to dismantle (sb./sth.) - демонтировать, разбирать, сносить что-л. [2]
otherwise - иначе, иным образом, по-другому [4]
terrain - местность, территория, район [1]
vital - важный, жизненный, существенный [3]
consumption - потребление, расход, использование [1]
to encircle - окружать, охватывать, опоясывать [2]
utmost - максимальный, крайний, предельный [3]
cordial - радушный, сердечный [3]
relish - удовольствие, пристрастие, смак [1]
humdrum - будничный, заурядный, однообразный [3]
bizarre - причудливый, странный, необычный [3]
to withdraw (sth.) - изымать, отзывать, забирать, уходить, отводить что-л. [2]
abrupt - крутой, резкий, обрывистый, неожиданный [3]
to content with sth. - довольствоваться, довольный чем-либо [2]
to persist - упорствовать, сохраняться, настойчиво продолжать [2]
narrative - повествование, рассказ, история [1]
plug - штекер, вилка, пробка, заглушка [1]
pin - штифт, штырь, значок, булавка [1]
labour - труд, работа [1]
drab - серость, однообразие [1]
pompous - напыщенный, помпезный [3]
obese - брюзгливый, тучный, жирный [3]
to bear (sb./sth.) - нести, выдерживать, терпеть, переносить что-л. [2]
intrusion - вторжение, внедрение, проникновение [1]
vow - обет, клятва [1]
to contribute (to sth.) - делать вклад, жертвовать, способствовать чему-л. [2]
insult - оскорбление, обида, повреждение [1]
subsidiary - филиал, дочерняя компания, подразделение [1]
chagrin - досада, огорчение, сожаление [1]
to stagger - шататься, покачиваться [2]
sample - образец, проба, выборка, модель [1]
immense - огромный, колоссальный, необъятный [3]
thorough - тщательный, основательный, обстоятельный, полный [3]
curriculum - учебный план, курс обучения [1]
peer - сверстник, ровня, коллега [1]
to boast - гордиться, хвастаться, похваляться [2]
to unwind (sth.) - разматывать что-л., расслабляться, развеяться [2]
sneer - глумление, насмешка [1]
gibe - колкость, издёвка [1]
abhorrent - вызывающий отвращение [5]
akin - схожий, сходный, родственный [3]
to predominate - возвышаться, превалировать [2]
eclipse - затмение, потускнение [1]
surgeon - врач, хирург [1]
wreckage - обломки, крушение, авария [1]
to impose sth. - налагать, накладывать, облагать чем-л. [2]
ignorant - невежественный, необразованный, безграмотный [3]
stinging - покалывание, жжение [1]
susceptible - предрасположенный, восприимчивый, чувствительный [3]
longing - стремление, тоска, тяга [1]
soil - почва, грунт, земля [1]
to flourish - процветать, преуспевать, расцветать [2]
to slay sb. - убить, умертвить, сразить кого-л. [2]
to suppress sth. - подавлять, сдерживать что-л. [2]
quail - перепёлка, куропатка [1]
porch - крыльцо, веранда, паперть [1]
to desert (sb./sth.) - оставлять, дезертировать, покидать кого-л./что-л. [2]
grave - серьёзный, веский, тяжкий [3]
culprit - виновник, преступник [1]
hen - курица [1]
fence - забор, ограждение, ограда, изгородь [1]
affectionate - ласковый, любящий, нежный [3]
to cheer up (sb.) - развеселить, ободрить кого-л. [2]
affair - дело, роман, инцидент [1]
bald - лысый, плешивый [3]
neat - аккуратный, опрятный, лаконичный, чёткий [3]
reed - тростник, камыш [1]
tenant - арендатор, съёмщик [1]
overcast - пасмурная погода, сплошная облачность [1]
endangered - вымирающий, исчезающий [3]
to endanger (sb./sth.) - подвергать кого-л./что-л. опасности, ставить под угрозу [2]
stove - плита, печь, духовка [1]
cutlery - столовые приборы [1]
scenery - пейзаж, декорации, сцена [1]
to retire (sb./sth.) - отступить, уходить на пенсию (в отставку) [2]
benefit  - благо, преимущество, польза, выгода [1]
jumble - нагромождение, беспорядок, путаница [1]
to betray sb. - предавать, подводить кого-л. [2]
moist - влажный, мокрый, дождливый [3]
to catch up (sb./sth.) - догнать, наверстать упущенное, нагонять кого-л./что-л. [2]
cloak - плащ, покров, мантия [1]
bargain - сделка, соглашение, договор [1]
milestone - веха, этап, контрольная точка [1]
agenda - повестка дня, программа, план мероприятий [1]
mill - мельница, фабрика [1]
stiff - тугой, плотный [3]
torque - момент, крутящий момент, момент силы [1]
flaw - недостаток, изъян, дефект [1]
vicious - порочный, злой, злобный [3]
candid - искренний, откровенный, беспристрастный [3]
cliff - утёс, скала, обрыв [1]
orchard - (фруктовый) сад [1]
to sprout (sth.) - отращивать что-л., давать всходы, распускаться [2]
to acquire sth. - приобретать, овладевать чем-л. [2]
wage - зарплата, заработок [1]
to pawn sth. - закладывать, оставлять что-л. в залог [2]
to wriggle - изгибаться, извиваться, кривляться [2]
eligible - соответствующий, годный [3]
to entitle (sb./sth.) - называть, озаглавливать, давать право кому-л. [2]
bequest - завещание, наследие, наследство [1]
obliging - любезный, услужливый [3]
vice - порок, недостаток [1]
trustee - доверенное лицо, попечитель, управляющий [1]
crib - детская кроватка, колыбель [1]
handy - удобный, сподручный, полезный [3]
interest - процент, интерес [1]
to accrue - нарастать, увеличиваться, доставаться [2]
berth - причал, должность [1]
confine - предел, граница [1]
shutters - жалюзи, ставни, створки [1]
to tramp - бродить, тяжело ступать [2]
barrow - тачка, тележка [1]
vivid - яркий, живой [3]
dejected - подавленный, разочарованный [5]
pinch - щепотка, щипок [1]
to wring sth. - крепко сжимать, скручивать, выжимать что-л. [2]
bashful - застенчивый, стыдливый [3]
to seize sth. - хватать, налагать арест на что-л., воспользоваться чем-л. [2]
to tug sth. - тащить, тянуть что-л. [2]
to deceive sb. - обманывать, вводить кого-л. в заблуждение [2]
benefactor - благотворитель, благодетель, меценат, покровитель [1]
to lengthen (sth.) - удлинять, вытягивать что-л. [2]
to budge (sb./sth.) - сдвинуть кого-л./что-л., шевелиться [2]
hoax - мистификация, обман [1]
fraud - мошенничество, фальсификация [1]
anyhow - во всяком случае, во что бы то ни стало, как бы то ни было [4]
diligence - усердие, трудолюбие, прилежание, осмотрительность [1]
cardboard - картон [1]
to dissolve sth. - растворять, распускать, расторгать что-л. [2]
curt - отрывистый, краткий, резкий [3]
rueful - жалкий, печальный, горестный [3]
to shove (sb./sth.) - толкать, отталкивать кого-л./что-л. [2]
accountant - бухгалтер, счетовод [1]
solicitor - адвокат, юрисконсульт [1]
grievance - жалоба, недовольство [1]
lad - мальчик, отрок [1]
gypsy - цыган, цыганка [1]
applicant - кандидат, соискатель, заявитель [1]
to comprise sth. - включать, составлять, заключать в себе что-л. [2]
to thrive - процветать, преуспевать, благоденствовать [2]
instance - экземпляр, пример, случай [1]
to beg (sb./sth.) - попрошайничать, упрашивать кого-л. [2]
to spare sth. - экономить что-либо, обходиться без чего-либо [2]
dingy - покрытый сажей, грязный, выцветший [3]
enclosure - корпус, ограждение, огороженное пространство [1]
gilt - золочёный, позолоченный [3]
to thump (sb./sth.) - колотить, стучать, бить [2]
vigorous - энергичный, сильный, решительный [3]
to enrol - записываться, регистрировать, вносить в список [2]
retired - в отставке, отставной, уединённый [5]
swarm - рой, толпа [1]
conundrum - парадоксальная ситуация, головоломка, загадка [1]
rehearsal - репетиция, повторение [1]
bait - наживка, приманка, прикорм [1]
merit - заслуга, достоинство [1]
gently - слегка, нежно, мягко, осторожно [4]